#######################
#    #           #    #
# ####           #### #
#                     #
#                     #
#                     #
#                     #
#                     #
#                     #
#                     #
#                     #
#          @          #
#                     #
#                     #
#                     #
#                     #
#                     #
#                     #
#                     #
#                     #
# #####          #### #
#     #          #    #
#######################