###############
#             #
#             #
#      #      #
#     ###     #
#      #      #
####      #   #
#  #          #
#  #      #   #
#  #          #
#         #   #
#  #          #
#  #      #   #
#  #          #
####     ##  ##
#             #
###############