#######################
#                     #
#                     #
#    # # # # ####  #  #
#           E#E #  #  #
#    #########  #  #  #
#    #          #  #  #
#    #          #  #  #
#    #   ###    #  #  #
#    #   # #    #  #E #
#    #   ###    #  ####
#    #                #
#    #                #
#   #######           #
#                     #
#                    @#
#   #######           #
#   #                 #
#   #                 #
#   #   # # # # # #   #
#   #   # # # # # #   #
#   #                 #
# E #                 #
#######################