#######################
#E                   E#
#                     #
#####            ######
#                     #
#                     #
#                     #
# # # # #     # # # # #
#                     #
#                     #
#                     #
#                     #
#          @          #
#                     #
#                     #
#                     #
#                     #
# # # # #     # # # # #
#                     #
#                     #
#                     #
#####             #####
#                     #
#E                   E#
#######################