########################
#         # #          #
#         # #          #
#         # #          #
#####     # #     ######
#   ##    ###    ##    #
#                      #
#   ##           ##    #
#####             ######
#                      #
#                      #
#                      #
########### ############
#                      #
#                      #
#                      #
########################