#######################
#   E             E   #
#                     #
#                     #
#                     #
#                     #
#                     #
#                     #
#                     #
#                     #
#                     #
#          @          #
#                     #
#                     #
#                     #
#                     #
#                     #
#                     #
#                     #
#                     #
#                     #
#    E           E    #
#######################