#######################
#                     #
# #   #  #   #   #    #
#                     #
#   #   #   #   #   # #
#                     #
# #   #   #   #   #   #
#                     #
#   #   #   #   #   # #
#                     #
# #   #   #   #   #   #
#                     #
#   #   #   #   #   # #
#                     #
# #   #   #   #   #   #
#                     #
#######################