############
# ###  ### #
#          #
#  # ## #  #
#          #
#  #    #  #
#          #
#  #    #  #
#          #
#  #    #  #
#          #
#  #    #  #
#          #
#  # ## #  #
#          #
#          #
############