############
#  ##   ## #
#          #
#          #
#          #
#    ##    #
##  #  #  ##
#  #    #  #
#  #    #  #
##  #  #  ##
#          #
#          #
#          #
#          #
#          #
#  ##   ## #
############