#######################
# X                   #
#                     #
#    # # # # #####  # #
#            #   #  # #
#    #########   #  # #
#    #           #  # #
#    #   ###     #  # #
#    #   # #     #  #X#
#    #   ###     #  ###
#    #                #
#    #                #
#   #######           #
#                     #
#                    @#
#   #######           #
#   #                 #
#   #                 #
#   #   # # # # # #   #
#   #   # # # # # #   #
#   #                 #
# X #                 #
#######################