#######################
#   E#           #E   #
# ####           #### #
#                     #
#                     #
#                     #
#                     #
#                     #
#                     #
#                     #
#                     #
#          @          #
#                     #
#                     #
#                     #
#                     #
#                     #
#                     #
#                     #
#                     #
# #####          #### #
#    E#          #E   #
#######################
